25 27
55 55 55 55 55 55 55 55 40 44 44 44 44 44 44 44 41 55 55 55 55 55 55 55 55
55 55 55 55 55 55 55 55 45 0 1 1 1 1 1 2 45 55 55 55 55 55 55 55 55
55 55 55 55 55 55 55 55 45 3 4 4 16 4 4 5 45 55 55 55 55 55 55 55 55
55 55 55 55 55 55 55 55 45 3 4 4 4 4 4 5 45 55 55 55 55 55 55 55 55
55 55 55 55 55 55 55 55 45 3 4 4 4 4 4 5 45 55 55 55 55 55 55 55 55
55 55 55 55 55 55 55 55 45 6 7 7 7 7 7 8 45 55 55 55 55 55 55 55 55
55 55 55 55 55 55 55 55 42 44 41 57 19 20 40 44 43 55 55 55 55 55 55 55 55
55 55 55 55 55 55 55 55 55 55 45 21 22 23 45 55 55 55 55 55 55 55 55 55 55
40 44 44 41 55 55 55 55 55 55 45 21 22 23 45 55 55 55 55 55 55 40 44 44 41
45 0 2 42 41 55 55 55 55 55 45 21 22 23 45 55 55 55 55 55 40 43 0 2 45
45 3 4 2 42 41 55 55 55 55 45 21 22 23 45 55 55 55 55 40 43 0 4 5 45
45 3 33 4 2 42 41 55 55 40 43 21 22 23 42 41 55 55 40 43 0 4 33 5 45
45 3 4 4 33 2 42 58 44 43 18 25 25 25 20 42 44 58 43 0 33 4 4 5 45
45 3 4 4 4 5 18 19 19 19 23 0 1 2 21 19 19 19 20 3 4 4 4 5 45
45 3 33 4 4 5 21 22 22 22 23 3 33 5 21 22 22 22 23 3 4 4 33 5 45
45 3 4 4 4 5 24 25 25 25 23 6 7 8 21 25 25 25 26 3 4 4 4 5 45
45 3 4 4 33 8 40 44 44 41 24 19 19 19 26 40 44 44 41 6 33 4 4 5 45
45 3 33 4 8 40 43 34 36 42 41 21 22 23 40 43 34 36 42 41 6 4 33 5 45
45 6 7 8 40 43 34 38 38 36 45 21 22 23 45 34 38 38 36 42 41 6 4 5 45
49 44 44 44 43 34 38 38 38 39 51 57 25 26 51 37 38 38 38 39 42 44 44 44 50
45 0 1 1 1 1 1 1 1 1 1 1 1 1 1 1 1 1 1 1 1 1 1 2 45
45 3 4 4 4 4 4 4 4 4 4 4 4 4 4 4 4 4 4 4 4 4 4 5 45
45 3 4 4 4 4 4 4 4 4 4 4 4 4 4 4 4 4 4 4 4 4 4 5 45
45 3 4 4 4 4 4 4 4 4 4 4 4 4 4 4 4 4 4 4 4 4 4 5 45
45 3 4 4 4 4 4 4 4 4 4 4 4 4 4 4 4 4 4 4 4 4 4 5 45
45 6 7 7 7 7 7 7 7 7 7 7 7 7 7 7 7 7 7 7 7 7 7 8 45
42 44 44 44 44 44 44 44 44 44 44 44 44 44 44 44 44 44 44 44 44 44 44 44 43