20 20
55 55 55 40 44 44 44 44 44 44 44 44 44 44 44 44 44 44 44 41
55 55 55 45 18 19 19 19 19 19 19 19 19 19 19 19 19 19 20 45
55 55 55 45 24 25 25 25 25 25 22 22 22 22 22 22 22 22 23 45
55 55 55 42 44 44 44 44 44 41 21 22 22 22 22 22 22 22 23 45
55 55 55 55 55 55 55 55 55 45 21 22 22 22 25 22 22 22 23 45
55 40 44 44 44 44 44 44 44 43 21 22 22 23 45 24 25 25 26 45
55 45 27 28 28 28 28 28 28 28 25 25 25 26 42 44 44 44 44 43
55 45 0 1 1 1 10 10 10 10 10 10 10 2 34 35 35 35 36 30
55 45 6 7 7 5 40 44 46 44 46 44 41 13 37 38 38 38 39 31
40 48 44 44 41 13 45 52 45 53 45 54 45 13 37 38 38 38 39 31
45 0 16 2 45 13 42 44 48 44 48 44 43 13 37 38 38 38 39 31
45 3 4 5 45 3 1 1 1 1 1 1 1 5 40 44 44 44 41 31
45 6 7 8 45 3 7 7 7 4 17 17 17 5 45 27 28 20 45 31
42 41 12 46 43 13 40 46 41 3 17 17 17 5 49 48 41 31 45 31
55 45 13 51 0 5 49 47 50 3 4 4 4 5 45 18 28 26 45 32
55 45 14 0 4 5 51 51 51 3 4 4 4 5 45 31 40 44 48 44
55 45 9 7 7 7 1 1 1 4 4 4 4 5 51 32 45 55 55 55
55 45 52 53 54 55 6 7 7 7 7 7 7 7 10 11 45 55 55 55
55 42 44 44 44 44 44 44 44 44 44 44 44 44 44 44 43 55 55 55
55 55 55 55 55 55 55 55 55 55 55 55 55 55 55 55 55 55 55 55