20 20
15 0 0 0 0 0 0 0 0 0 0 0 0 0 0 0 0 0 0 15
0 0 0 0 0 0 0 0 0 0 0 0 0 0 0 0 0 0 0 0
0 0 0 0 0 0 0 0 0 0 0 0 0 0 0 0 0 0 0 0
0 0 0 0 0 0 0 0 0 0 0 0 0 0 0 0 0 0 0 0
0 14 14 14 0 14 0 14 0 14 0 14 14 14 0 14 14 14 14 0
0 14 0 0 0 14 0 14 0 14 0 14 0 14 0 14 0 0 0 0
0 14 14 14 0 14 0 14 0 14 0 14 14 14 0 14 0 14 14 0
0 0 0 14 0 14 0 14 0 14 0 14 0 14 0 14 0 0 14 0
0 14 14 14 0 14 14 14 14 14 0 14 0 14 0 14 14 14 14 0
0 0 0 0 0 0 0 0 0 0 0 0 0 0 0 0 0 0 0 0
0 0 0 0 0 0 0 0 0 0 0 0 0 0 0 0 0 0 0 0
0 0 0 0 0 0 0 8 8 8 0 0 0 0 0 0 0 0 0 0
0 0 0 0 0 0 0 8 8 8 0 0 0 18 17 19 0 0 0 0
0 0 0 0 0 0 5 11 7 0 0 0 18 17 17 17 19 0 0 0
0 0 0 10 0 10 0 0 4 0 0 0 0 16 16 16 0 0 0 0
0 0 0 9 3 9 0 0 7 11 6 0 0 21 16 20 0 0 0 0
0 0 0 13 0 13 0 0 12 0 0 0 0 16 22 16 1 0 0 0
0 0 0 0 0 0 0 0 0 0 0 0 0 0 0 0 0 0 0 0
0 0 2 2 2 2 2 0 0 0 0 0 0 0 0 0 0 0 0 0
15 0 2 23 23 23 2 0 0 0 0 0 0 0 0 0 0 0 0 15