17 12
40 44 44 44 44 44 44 44 44 44 44 44 44 44 44 44 41
45 4 4 4 4 4 4 4 4 18 19 20 4 4 4 4 45
45 4 4 0 1 1 1 2 4 24 16 26 4 4 4 4 45
45 4 4 3 4 4 4 5 4 4 4 56 4 4 4 4 45
45 4 4 3 4 4 4 5 4 4 4 4 4 4 4 4 45
45 4 4 3 4 4 4 5 4 4 4 4 4 4 4 4 45
45 4 4 3 4 4 4 5 4 4 4 4 17 17 17 4 45
45 4 4 6 7 7 7 8 4 4 4 4 17 17 17 4 45
45 4 4 10 10 10 10 10 4 4 4 4 17 17 17 4 45
45 4 4 34 36 36 36 36 4 4 4 4 17 17 17 4 45
45 4 4 37 38 38 38 39 4 4 4 4 4 4 4 4 45
42 44 44 44 44 44 44 44 44 44 44 48 48 48 48 48 43